var me = moment.defineLocale('me', {
        months: 'januar_februar_mart_april_maj_jun_jul_avgust_septembar_oktobar_novembar_decembar'.split(
            '_'
        ),
        monthsShort:
            'jan._feb._mar._apr._maj_jun_jul_avg._sep._okt._nov._dec.'.split('_'),
        monthsParseExact: true,
        weekdays: 'nedjelja_ponedjeljak_utorak_srijeda_četvrtak_petak_subota'.split(
            '_'
        ),
        weekdaysShort: 'ned._pon._uto._sri._čet._pet._sub.'.split('_'),
        weekdaysMin: 'ne_po_ut_sr_če_pe_su'.split('_'),
        weekdaysParseExact: true,
        longDateFormat: {
            LT: 'H:mm',
            LTS: 'H:mm:ss',
            L: 'DD.MM.YYYY',
            LL: 'D. MMMM YYYY',
            LLL: 'D. MMMM YYYY H:mm',
            LLLL: 'dddd, D. MMMM YYYY H:mm',
        },
        calendar: {
            sameDay: '[danas u] LT',
            nextDay: '[sjutra u] LT',

            nextWeek: function () {
                switch (this.day()) {
                  ...
_tmp_1.relativeTime = {
            future: '%s barru',
            past: 'duela %s',
            s: 'segundo batzuk',
            ss: '%d segundo',
            m: 'minutu bat',
            mm: '%d minutu',
            h: 'ordu bat',
            hh: '%d ordu',
            d: 'egun bat',
            dd: '%d egun',
            M: 'hilabete bat',
            MM: '%d hilabete',
            y: 'urte bat',
            yy: '%d urte',
        }
setMonth(mom, get(mom, 'Month') + months * isAdding)
updateOffset = updateOffset == null ? true : updateOffset
mom._d.setTime(mom._d.valueOf() + milliseconds * isAdding)
set$1(mom, 'Date', get(mom, 'Date') + days * isAdding)
